%%%%%%%%%%%%%%%%%
%               %
%    %  %%%%    %
%    %  % .%    %
%P   %  %% %   .%
%  G %  %  %    %
%  .       %    %
%%%%%%%%%%%%%%%%%