%%%%%%%%%%%%%%%%%
%   %.    %    .%
%      .  % %%%%%
% % %%%%%      .%
%P      %.   %%%%
%       %%%   G %
%        .     .%
%%%%%%%%%%%%%%%%%