%%%%%%%%%%%%%%%%%
%    .         .%
%      .%%%%%   %
%   %%%%%   %  .%
%P  G   %.  %   %
%       %%% %   %
%        .     .%
%%%%%%%%%%%%%%%%%