%%%%%%%
%%  G %
%. %%%%
%P%%%%%
% . %%%
%%%%%%%
