%%%%%%%%%
%.%.%.%P%
%       %
%%%% %%%%
%.%..%%.%
%   %%% %
% .   . %
%%%%%%%%%