%%%%%%%%%%%%%%%%%%%%%%%%%%%%%%
%.      % % %.             %.%
%       % % %%%%%% %%%%%%% % %
%      .%  o     %   . % %   %
%%%%% %%%%% %%% %% %%%%% % %%%
%   % % % %   %    %     %   %
% %%% % % % %%%%%%%% %%% %%% %
%       %     %%     % % %   %
%%% % %%%%%%% %%%% %%% % % % %
% %           %%     %    o% %
% % %%%%% % %%%% % %%% %%% % %
%   %     %    . % %  .% %%% %
%.  %P%%%%% o    % %%% %    .%
%%%%%%%%%%%%%%%%%%%%%%%%%%%%%%
