%%%%%%%%%%%%%%%%%%%
%.................%
%%%% %%%%%%%%%%%%o%
%oooo%%%%%%%%%%%% %
% %%%%            %
%.%%%%.%%%%%%%%%%%%
%                 %
%%%.%%%%.%%%%o%%%.%
%%% % % % % % % % %
%%%P%%%%%%%%%%%%%%%
%%%%%%%%%%%%%%%%%%%