%%%%%%%%%
%.%.%.%P%
%       %
%%%% %%.%
%.%..%%.%
% o %%% %
% .  o..%
%%%%%%%%%